NO ./assets/north.xpm
SO ./assets/south.xpm
WE ./assets/west.xpm
EA ./assets/east.xpm

F 220,100,0
C 225,30,0

111111111111111 1111
100000000000001110011111111
10000000000000111001
100000000000000000N1
111111111111111111111111
1 1 1 1 1 1            1
11111
10001
11111