NO textures/ice.xpm
SO textures/lava.xpm
WE textures/bricks.xpm
EA textures/leaves.xpm

F 101,183,65
C 123,211,234

1111111
1000001 111
1000001 101
1000001 111
1W00001
1111111