NO textures/north.xpm
SO textures/south.xpm
WE textures/west.xpm
EA textures/east.xpm

F 101,183,65
C 123,211,234

1111111
1001001 111
100D001 101
1001001 111
1W00001
1111111
