NO textures/north.xpm
SO textures/south.xpm
WE textures/west.xpm
EA textures/east.xpm


F 45,45,45
C 0,0,0

111111111111111111111111111111
100000000000000000000000000W01
1111D111110011111D111111111111
111101111100111110111111111111
111101111100111110111111111111
111101111100111110000000000111
1111D1111000011111111111110111
100000001000001111111111110111
10000000D00000000000D000000001
100000001000001111111111110111
1111D1111000001111111111110111
111101111111111111111111110111
111100000000000000000000000111
111111111111111111111111111111