NO textures/north.xpm
SO textures/south.xpm
WE textures/west.xpm
EA textures/east.xpm


F 45,45,45
C 0,0,0

111111111111111111111
  1001000000100000W01
  1001011D11110111111
  100101101111D111111
  100D011011110111111
  1111011000000111111
  1111111111011111111
111111111111011111111
11111111111111111111