NO textures/north.xpm
SO textures/south.xpm

WE textures/west.xpm
EA textures/east.xpm

F 101,183,65



C 123,211,234


1111111111
1000000001
1N00000001
1000000001
1001000001
1001110101
1000010101
1000010101
1000000001
1111111111